----------------------------------------------------------------
----------------------------------------------------------------
-----------------------PPP--------------------------------------
---------------------PP-PP--------------------------------------
P-----------------------PP--------------------------------------
P-----------------------PP--------------------------------------
P--------------------PPPPPPPP-----------------------------------
P----------------------------------------------K-K-K------------
P-----------------------------------------------PPPPP-----------
P----------------------------------------K----------------------
-P-P-P-P-P---------------------PPP---P--PPPP--------------------
-------P------------------PP------------------------------------
-------P------CCC-----P--D----D---D--PPP-----------------G------
-PPPPPPPPPPPPPPPPPPPPPPPPPPPPPPPPPPPPPPPPPPPPPLLLLPPPPPPPPPPPPP-
----------------------------------------------------------------
----------------------------------------------------------------
~~~~~~                    NEW SECTION                    ~~~~~~~
----------------------------------------------------------------
----------------------------------------------------------------
----------------------------------------------------------------
---------------------PP-PP--------------------------------------
P-----------------------PP--------------------------------------
P-----------------------PP--------------------------------------
P--------------------PPPPPPPP-----------------------------------
P----------------------------------------------K-K-K------------
P-----------------------------------------------PPPPP-----------
P----------------------------------------K----------------------
-P-P-P-P-P---------------------PPP---P--PPPP--------------------
-------P------------------PP------------------------------------
-------P------CCC-----P--D----D---D--PPP-----------------G------
-PPPPPPPPPPPPPPPPPPPPPPPPPPPPPPPPPPPPPPPPPPPPPPPPPPPPPPPPPPPPPP-
----------------------------------------------------------------
----------------------------------------------------------------
~~~~~~                    NEW SECTION                    ~~~~~~~
----------------------------------------------------------------
----------------------------------------------------------------
----------------------------------------------------------------
----------------------------------------------------------------
P---------------------------------------------------------------
P-----------------------PP--------------------------------------
P--------------------PPPPPPPP-----------------------------------
P----------------------------------------------K-K-K------------
P-----------------------------------------------PPPPP-----------
P----------------------------------------K----------------------
-P-P-P-P-P---------------------PPP---P--PPPP--------------------
-------P------------------PP------------------------------------
-------P------CCC-----P--D----D---D--PPP-----------------G------
-PPPPPPPPPPPPPPPPPPPPPPPPPPPPPPPPPPPPPPPPPPPPPPPPPPPPPPPPPPPPPP-
----------------------------------------------------------------
----------------------------------------------------------------
~~~~~~                    NEW SECTION                    ~~~~~~~
----------------------------------------------------------------
----------------------------------------------------------------
----------------------------------------------------------------
----------------------------------------------------------------
P---------------------------------------------------------------
P---------------------------------------------------------------
P--------------------PPPPPPPP-----------------------------------
P----------------------------------------------K-K-K------------
P-----------------------------------------------PPPPP-----------
P----------------------------------------K----------------------
-P-P-P-P-P---------------------PPP---P--PPPP--------------------
-------P------------------PP------------------------------------
-------P------CCC-----P--D----D---D--PPP-----------------G------
-PPPPPPPPPPPPPPPPPPPPPPPPPPPPPPPPPPPPPPPPPPPPPPPPPPPPPPPPPPPPPP-
----------------------------------------------------------------
----------------------------------------------------------------