P--------------------------------------------------------------P
P--------------------------------------------------------------P
P--------------------------------------------------------------P
P--------------------------------------------------------------P
P--------------------------------------------------------------P
P--------------------------------------------------------------P
P--------------------------------------------------------------P
P----------------------------------------------K--G------------P
P---------------------------------------PPPPPPPPPPPPPPPPPPPPPPPP
P---------------------------------PP----P-----------------------
P---------------------------------------P-----------------------
P-----------------------------PPPPPPPPPPP-----------------------
P-----------------------------D---------------------C-----------
PPPPPPPPPPPPPPPPPPPPPPPPPPPPPPPPPPPPPPPPPPPPPP---PPPPPPPPPPPPPPP
PPPPPPPPPPPPPPPPPPPPPPPPPPPPPPPPPPPPPPPPPPPPPPLLLPPPPPPPPPPPPPPP
PPPPPPPPPPPPPPPPPPPPPPPPPPPPPPPPPPPPPPPPPPPPPPPPPPPPPPPPPPPPPPPP
~~~~~~                    NEW SECTION                    ~~~~~~~
P-------------------------P-------------------------------------
P-------------------------P-------------------------------------
P-------------------------P-------------------------------------
P-------------------------P-------------------------------------
P-------------------------PPP-----------------------------------
P---------------------------D-----------------------------------
P--------------------PPPPPPPP-----------------------------------
P---------------------------------------------------------------
P-----------------P-----------------C---------------------------
P--K--------PPP---------------------P---------------------------
P---------------------------------------------------------------
PPPPPPPP--------------------------------P-----------------------
P------D------G-----------------------------G-------------------
PPPPPPPPPPPPPPPPPPPPPPPPP-----PP-----PPPPPPPPPPPPPPPPPPPPPPPPPPP
PPPPPPPPPPPPPPPPPPPPPPPPPLLLLLLLLLLLLPPPPPPPPPPPPPPPPPPPPPPPPPPP
PPPPPPPPPPPPPPPPPPPPPPPPPPPPPPPPPPPPPPPPPPPPPPPPPPPPPPPPPPPPPPPP
~~~~~~                    NEW SECTION                    ~~~~~~~
P---------------------------------------------------------------
P---------------------------------------------------------------
P---------------------------------------------------------------
P---------------------------------------------------------------
P---------------------------------------------------------------
P---------------------------------------------------------------
P---------------------------------------------------------------
P---------------------------------------------------------------
P---------------------------------------------------------------
P---------------------------------------------------------------
P---------------------------------------------------------------
P---------------------------------------------------------------
P-----------------------------C---------------------------------
PPPPPPPPPPPPPPPPPPPPPPPPP-----PP-----PPPPPPPPPPPPPPPPPPPPPPPPPPP
PPPPPPPPPPPPPPPPPPPPPPPPPLLLLLLLLLLLLPPPPPPPPPPPPPPPPPPPPPPPPPPP
PPPPPPPPPPPPPPPPPPPPPPPPPPPPPPPPPPPPPPPPPPPPPPPPPPPPPPPPPPPPPPPP
~~~~~~                    NEW SECTION                    ~~~~~~~
P---------------------------------------------------------------
P---------------------------------------------------------------
P---------------------------------------------------------------
P---------------------------------------------------------------
P---------------------------------------------------------------
P---------------------------------------------------------------
P---------------------------------------------------------------
P---------------------------------------------------------------
P---------------------------------------------------------------
P-------------K-------------------------------------------------
P------------PP----------PPP-----------------------PP-----------
P-----PPP-----------------------------PPP-----------------------
P-----P-------------G------------------------------------------D
PPPPPPPLLLLLLLLLPPPPPPPPPLLLLLLLPLLLLLLLPPPPPPPPPLLLLLLLLLPPPPPP
PPPPPPPPPPPPPPPPPPPPPPPPPPPPPPPPPPPPPPPPPPPPPPPPPPPPPPPPPPPPPPPP
PPPPPPPPPPPPPPPPPPPPPPPPPPPPPPPPPPPPPPPPPPPPPPPPPPPPPPPPPPPPPPPP