----------------------------------------------------------------
----------------------------------------------------------------
----------------------------------------------------------------
----------------------------------------------------------------
P---------------------------------------------------------------
P---------------------------------------------------------------
P---------------------------------------------------------------
P----------------------------------------------C-C-C------------
P-----------------------------------------------PPPPP-----------
P---------------------------------------------------------------
-P-P-P-P-P------------------------------PPPP--------------------
-------P--------------------------------------------------------
-------P-----------------------------PPP-----------------G------
-PPPPPPPPPPPPPPPPPPPPPPPPPPPPPPPPPPPPPPPPPPPLLLLPPPPPPPPPPPPPPP-
----------------------------------------------------------------
----------------------------------------------------------------
~~~~~~                    NEW SECTION                    ~~~~~~~
----------------------------------------------------------------
----------------------------------------------------------------
----------------------------------------------------------------
----------------------------------------------------------------
----------------------------------------------------------------
----------------------------------------------------------------
----------------------------------------------------------------
----------------------------------------------------------------
----------------------------------------------------------------
----------------------------------------------------------------
----------------------------------------------------------------
----------------------------------------------------------------
----------------------------------------------------------------
----------------------------------------------------------------
----------------------------------------------------------------
----------------------------------------------------------------
~~~~~~                    NEW SECTION                    ~~~~~~~
----------------------------------------------------------------
----------------------------------------------------------------
----------------------------------------------------------------
----------------------------------------------------------------
----------------------------------------------------------------
----------------------------------------------------------------
----------------------------------------------------------------
----------------------------------------------------------------
----------------------------------------------------------------
----------------------------------------------------------------
----------------------------------------------------------------
----------------------------------------------------------------
----------------------------------------------------------------
----------------------------------------------------------------
----------------------------------------------------------------
----------------------------------------------------------------
~~~~~~                    NEW SECTION                    ~~~~~~~
----------------------------------------------------------------
----------------------------------------------------------------
----------------------------------------------------------------
----------------------------------------------------------------
----------------------------------------------------------------
----------------------------------------------------------------
----------------------------------------------------------------
----------------------------------------------------------------
----------------------------------------------------------------
----------------------------------------------------------------
----------------------------------------------------------------
----------------------------------------------------------------
----------------------------------------------------------------
----------------------------------------------------------------
----------------------------------------------------------------
----------------------------------------------------------------