----------------------------------------------------------------
----------------------------------------------------------------
----------------------------------------------------------------
---------------------PP-----------------------------------------
P--------------------PP-----------------------------------------
P-------------------PPPP---------------------------------------
P---------------------------------------------------------------
P----------------------------------------------K-K-K------------
P-----------------------------------------------PPPPP-----------
P----------------------------------------K----------------------
-P-P-P-P-P---------------------PPP---P--PPPP--------------------
-------P------------------PP------------------------------------
-------P------CCC-----P--D----D---D--PPP-----------------G------
-PPPPPPPPPPPPPPPPPPPPPPPPPPPPPPPPPPPPPPPPPPPPPPPPPPPPPPPPPPPPPP-
----------------------------------------------------------------
----------------------------------------------------------------
~~~~~~                    NEW SECTION                    ~~~~~~~
----------------------------------------------------------------
----------------------------------------------------------------
----------------------------------------------------------------
----------------------------------------------------------------
----------------------------------------------------------------
----------------------------------------------------------------
----------------------------------------------------------------
----------------------------------------------------------------
----------------------------------------------------------------
----------------------------------------------------------------
----------------------------------------------------------------
----------------------------------------------------------------
----------------------------------------------------------------
----------------------------------------------------------------
----------------------------------------------------------------
----------------------------------------------------------------
~~~~~~                    NEW SECTION                    ~~~~~~~
----------------------------------------------------------------
----------------------------------------------------------------
----------------------------------------------------------------
----------------------------------------------------------------
----------------------------------------------------------------
----------------------------------------------------------------
----------------------------------------------------------------
----------------------------------------------------------------
----------------------------------------------------------------
----------------------------------------------------------------
----------------------------------------------------------------
----------------------------------------------------------------
----------------------------------------------------------------
----------------------------------------------------------------
----------------------------------------------------------------
----------------------------------------------------------------
~~~~~~                    NEW SECTION                    ~~~~~~~
----------------------------------------------------------------
----------------------------------------------------------------
----------------------------------------------------------------
----------------------------------------------------------------
----------------------------------------------------------------
----------------------------------------------------------------
----------------------------------------------------------------
----------------------------------------------------------------
----------------------------------------------------------------
----------------------------------------------------------------
----------------------------------------------------------------
----------------------------------------------------------------
----------------------------------------------------------------
----------------------------------------------------------------
----------------------------------------------------------------
----------------------------------------------------------------